##########    #####################
#        #    #                   #
#  ##    #    #                   #
#  ##    #    #                   #
#        ######                   #
#                                 #
#        ######                   #
#        #    #                   #
#        #    #                   #
##########    #########   #########
                      #   #        
                      #   #        
              #########   #########
              #                   #
              #                   #
              #                   #
              #                   #
              #                   #
              #####################